MMMMMMMMMMMMM
M M     M   M
MMM     M   M
M           M
MMMM  MM   MM
M     M     M
MMMMMMMMMMMMM