MMMMMMMMMMMMM
M M     M   M
M           M
M    MMM    M
M    MMM    M
M    MMM    M
MMMMMMMMMMMMM